codice_nuts_3,codice_provincia,Provincia,Maschi celibi,Maschi coniugati,Maschi divorziati,Maschi vedovi,Maschi uniti civilmente,Maschi già in unione civile (per scioglimento),Maschi già in unione civile (per decesso del partner),Totale Maschi,Femmine nubili,Femmine coniugate,Femmine divorziate,Femmine vedove,Femmine unite civilmente,Femmine già in unione civile (per scioglimento),Femmine già in unione civile (per decesso del partner),Totale Femmine,Totale
ITC11,001,Torino,496745,508363,41541,31973,845,12,12,1079491,425272,519395,61819,144503,451,13,2,1151455,2230946
ITC12,002,Vercelli,37397,39090,3149,2683,40,1,0,82360,29796,39555,4171,13491,16,1,0,87030,169390
ITC15,003,Novara,81479,85253,6006,4857,73,3,0,177671,67963,86769,8202,24327,46,2,0,187309,364980
ITC16,004,Cuneo,134923,136954,9568,7730,108,1,0,289284,109361,137250,12361,37795,60,2,0,296829,586113
ITC17,005,Asti,46136,50520,3955,3224,78,0,0,103913,37265,50386,5214,15172,58,2,0,108097,212010
ITC18,006,Alessandria,90358,97209,8254,6814,109,2,0,202746,73355,98009,10925,32191,60,2,0,214542,417288
ITC20,007,Valle d'Aosta/Vallée d'Aoste,30095,26565,2754,1674,32,1,0,61121,25103,26870,3728,8186,24,2,0,63913,125034
ITC31,008,Imperia,46268,46465,5051,3262,48,0,0,101094,38525,47483,6930,15319,29,2,0,108288,209382
ITC32,009,Savona,58304,61713,5866,4468,64,0,1,130416,49426,62756,8061,21154,17,1,1,141416,271832
ITC33,010,Genova,177137,186153,16971,13116,280,0,0,393657,151744,191962,24842,63806,180,3,0,432537,826194
ITC34,011,La Spezia,46877,50955,4195,3139,37,1,0,105204,38587,51765,5697,16136,29,0,0,112214,217418
ITC41,012,Varese,199246,206537,14108,10906,170,2,2,430971,171572,209506,19242,53486,95,1,3,453905,884876
ITC42,013,Como,138111,139399,8924,7171,130,1,4,293740,116883,140365,11932,34638,84,0,0,303902,597642
ITC44,014,Sondrio,42945,40686,2782,2255,16,0,0,88684,34849,41183,3448,12243,17,1,0,91741,180425
ITC4C,015,Milano,781116,715683,47859,38775,1954,12,26,1585425,685538,732046,75624,185946,718,16,14,1679902,3265327
ITC46,016,Bergamo,263914,257810,14904,12906,314,4,1,549853,218828,259539,19144,60635,125,2,0,558273,1108126
ITC47,017,Brescia,295409,290066,19727,14162,441,4,2,619811,246289,291995,25868,71266,195,7,6,635626,1255437
ITC48,018,Pavia,123684,123254,9673,7565,141,1,7,264325,101286,124024,12377,38279,74,4,7,276051,540376
ITC4A,019,Cremona,82393,83400,4933,4759,113,2,2,175602,65894,84183,6457,23725,44,1,2,180306,355908
ITC4B,020,Mantova,93127,95242,6501,5129,100,1,2,200102,75944,95979,8515,26335,43,1,0,206817,406919
ITH10,021,Bolzano/Bozen,141686,108505,8054,5216,128,0,3,263592,122958,109624,10943,25460,62,0,5,269052,532644
ITH20,022,Trento,131870,121539,8645,5739,117,2,2,267914,112187,123481,11320,30459,63,0,1,277511,545425
ITH31,023,Verona,214428,213928,15071,10065,241,3,0,453736,181698,216230,20400,52525,141,10,2,471006,924742
ITH32,024,Vicenza,201599,199057,11929,9183,208,4,0,421980,168594,200715,15560,48370,75,1,2,433317,855297
ITH33,025,Belluno,47264,44379,3336,2856,34,1,1,97871,39665,44869,4219,14670,14,1,0,103438,201309
ITH34,026,Treviso,206463,206232,12153,9852,155,2,1,434858,173709,209040,16272,49559,82,0,2,448664,883522
ITH35,027,Venezia,188554,200152,12174,11294,227,0,1,412402,159972,204253,16982,55104,111,5,0,436427,848829
ITH36,028,Padova,217281,215651,12379,10452,211,3,4,455981,187641,219441,16980,53548,107,1,1,477719,933700
ITH37,029,Rovigo,50593,55505,3422,3344,22,2,1,112889,41562,56237,4155,16881,9,0,1,118845,231734
ITH42,030,Udine,118558,119924,9499,7269,108,1,3,255362,98983,121334,12732,37983,67,2,11,271112,526474
ITH43,031,Gorizia,30897,31757,2936,2044,23,0,2,67659,24759,31240,3790,10332,13,1,1,70136,137795
ITH44,032,Trieste,51398,50025,5837,3701,88,0,0,111049,42900,50351,8749,18360,36,0,0,120396,231445
ITH51,033,Piacenza,65594,66446,4465,3849,69,2,0,140425,53439,67027,5793,19718,28,0,3,146008,286433
ITH52,034,Parma,107220,102272,7150,5793,112,0,0,222547,90175,104454,10035,27601,61,0,0,232326,454873
ITH53,035,Reggio nell'Emilia,126629,119327,8356,6284,138,2,0,260736,105921,121267,11515,30061,109,0,0,268873,529609
ITH54,036,Modena,168992,157487,11312,8718,172,2,3,346686,145178,159051,15707,40389,105,2,1,360433,707119
ITH55,037,Bologna,241424,220455,16444,14392,464,1,5,493185,216278,225195,24887,61669,277,4,6,528316,1021501
ITH56,038,Ferrara,75118,78478,6478,5748,87,3,0,165912,63509,80099,8872,26077,40,0,1,178598,344510
ITH57,039,Ravenna,90090,85333,7706,5501,128,1,2,188761,78175,85621,10564,24782,67,0,0,199209,387970
ITH58,040,Forlì-Cesena,91983,89241,6068,5282,85,1,0,192660,78698,91106,8634,24183,24,1,0,202646,395306
ITI31,041,Pesaro e Urbino,81757,82846,5101,4483,62,3,0,174252,68900,84126,6726,22467,23,2,1,182245,356497
ITI32,042,Ancona,105812,108723,5978,5845,107,1,1,226467,90315,110945,8358,31319,44,3,0,240984,467451
ITI33,043,Macerata,69973,73558,3646,3863,21,1,0,151062,58323,74615,4870,21936,6,1,2,159753,310815
ITI34,044,Ascoli Piceno,45818,49212,2381,2557,30,0,0,99998,38437,50129,3296,14300,11,1,0,106174,206172
ITI11,045,Massa-Carrara,41616,45030,3302,2757,47,0,0,92752,34226,45561,4437,14680,29,0,0,98933,191685
ITI12,046,Lucca,83803,88380,7212,5338,157,0,1,184891,71025,90656,9880,25980,106,2,3,197652,382543
ITI13,047,Pistoia,62926,69373,4494,4042,52,0,1,140888,54125,71061,6505,19055,62,0,1,150809,291697
ITI14,048,Firenze,229637,219549,14451,13388,419,2,5,477451,209411,224801,22098,61518,231,1,6,518066,995517
ITI16,049,Livorno,70120,78385,6463,4957,76,2,0,160003,60619,79071,9143,22970,69,2,0,171874,331877
ITI17,050,Pisa,93509,98306,5960,5686,148,1,1,203611,80135,99975,8354,25956,88,3,0,214511,418122
ITI18,051,Arezzo,74059,81614,4946,4749,59,0,0,165427,61961,83267,6808,21688,20,0,1,173745,339172
ITI19,052,Siena,58583,62136,3346,3578,53,0,0,127696,50489,63886,4940,18126,42,0,0,137483,265179
ITI1A,053,Grosseto,47719,51486,3724,3315,53,0,0,106297,40627,51388,5225,16128,25,0,0,113393,219690
ITI21,054,Perugia,142944,153827,7410,8315,140,0,1,312637,122681,156999,10980,43349,62,2,0,334073,646710
ITI22,055,Terni,46699,53867,3259,3398,33,1,0,107257,39690,55343,4671,16476,17,0,1,116198,223455
ITI41,056,Viterbo,68991,74168,4582,4169,56,1,2,151969,57567,73464,6027,20734,32,2,0,157826,309795
ITI42,057,Rieti,34428,36979,1852,2214,17,0,0,75490,28378,36173,2228,10216,12,0,0,77007,152497
ITI43,058,Roma,994765,933035,58916,50130,1984,17,29,2038876,914485,962202,100809,235960,955,14,13,2214438,4253314
ITI44,059,Latina,129076,135887,6438,6582,78,0,2,278063,108365,135864,8785,31478,34,0,3,284529,562592
ITI45,060,Frosinone,105642,118620,4255,6249,17,0,0,234783,87914,118336,5578,30881,10,0,0,242719,477502
ITF31,061,Caserta,209648,222990,4259,10552,69,2,2,447522,185288,225816,7032,47981,19,2,6,466144,913666
ITF32,062,Benevento,60942,67015,1616,3828,6,0,0,133407,51351,67359,2248,17952,1,0,0,138911,272318
ITF33,063,Napoli,700894,719300,17224,35138,310,4,3,1472873,634679,741524,30590,154598,134,8,4,1561537,3034410
ITF34,064,Avellino,91112,102094,2442,5780,25,0,1,201454,77411,102149,3502,25844,7,2,0,208915,410369
ITF35,065,Salerno,246573,262565,6518,13617,85,2,0,529360,211855,266258,10338,63538,31,0,0,552020,1081380
ITF11,066,L'Aquila,66875,71625,3279,3952,22,5,1,145759,54978,70267,4205,19608,14,5,2,149079,294838
ITF12,067,Teramo,68437,73641,2861,3714,51,1,0,148705,56972,74416,3950,19843,11,1,2,155195,303900
ITF13,068,Pescara,70528,74436,3935,3682,33,0,0,152614,61332,76772,5851,19763,31,0,0,163749,316363
ITF14,069,Chieti,82139,93505,4032,4959,30,0,0,184665,68444,94155,5283,26277,15,1,0,194175,378840
ITF22,070,Campobasso,48311,53694,1761,2995,7,0,0,106768,39570,53441,2253,15324,5,1,0,110594,217362
ITF46,071,Foggia,137851,148404,3801,7841,30,0,0,297927,119693,149147,5479,34643,14,1,0,308977,606904
ITF47,072,Bari,264547,310844,9869,14764,110,3,2,600139,235579,314534,14788,65082,78,1,4,630066,1230205
ITF43,073,Taranto,122760,139460,4212,7028,55,4,0,273519,109974,141110,6268,33106,14,3,1,290476,563995
ITF44,074,Brindisi,83988,93988,3341,4903,44,1,1,186266,76719,94579,4787,22870,13,0,1,198969,385235
ITF45,075,Lecce,168469,190870,5980,10141,65,0,0,375525,156898,193213,8482,48026,21,0,0,406640,782165
ITF51,076,Potenza,79623,89360,2199,5051,9,0,0,176242,66045,88838,3014,24258,4,0,0,182159,358401
ITF52,077,Matera,44134,47875,1462,2429,8,0,0,95908,37132,47699,1799,12305,10,0,0,98945,194853
ITF61,078,Cosenza,155163,169984,4195,8755,17,2,0,338116,132980,170304,6228,42870,4,0,1,352387,690503
ITF63,079,Catanzaro,78254,85375,2512,4102,16,0,0,170259,67679,86169,3457,21769,10,1,0,179085,349344
ITF65,080,Reggio di Calabria,121117,128179,2959,6461,18,0,0,258734,103383,129774,4530,34541,5,0,0,272233,530967
ITG11,081,Trapani,93112,105813,2812,5027,31,0,0,206795,77640,105583,4014,27214,9,0,1,214461,421256
ITG12,082,Palermo,269312,298211,9159,14477,162,4,0,591325,246175,300997,14609,69786,93,2,1,631663,1222988
ITG13,083,Messina,135860,146313,6018,8109,47,3,1,296351,121448,147237,8621,40209,20,0,1,317536,613887
ITG14,084,Agrigento,92761,105991,2367,4853,27,0,1,206000,79670,106341,3158,28309,8,1,1,217488,423488
ITG15,085,Caltanissetta,55597,63468,1845,2964,9,0,0,123883,49115,63544,2544,16839,6,0,0,132048,255931
ITG16,086,Enna,35027,39238,1136,2114,3,2,0,77520,30882,39354,1541,10862,2,0,0,82641,160161
ITG17,087,Catania,244468,256310,8099,11752,117,4,0,520750,218637,260159,13044,59977,63,3,1,551884,1072634
ITG18,088,Ragusa,72688,77854,2555,3388,28,0,1,156514,59828,77312,3551,18391,5,0,0,159087,315601
ITG19,089,Siracusa,88023,95178,3775,4794,34,0,0,191804,73498,95431,4994,23585,30,2,0,197540,389344
ITG2D,090,Sassari,117280,108802,6724,5749,87,0,0,238642,100788,108848,8141,27956,32,0,0,245765,484407
ITG2E,091,Nuoro,52656,44544,1642,2262,10,0,0,101114,43870,44480,1903,13828,10,0,0,104091,205205
ITG2F,092,Cagliari,100972,93059,5918,4763,81,2,2,204797,92258,94463,8479,22794,45,1,3,218043,422840
ITH41,093,Pordenone,71284,72616,4888,3829,32,0,0,152649,58221,73613,6731,19261,26,0,1,157853,310502
ITF21,094,Isernia,18651,20596,667,1267,4,0,0,41185,15057,20137,798,5977,0,0,0,41969,83154
ITG2G,095,Oristano,37273,35586,1444,2044,3,0,0,76350,31082,35571,1726,10238,6,1,0,78624,154974
ITC13,096,Biella,37403,40007,3402,2917,52,0,0,83781,31214,40800,4683,13663,27,1,1,90389,174170
ITC43,097,Lecco,77896,78935,4289,4030,76,0,3,165229,65546,79168,5480,19505,31,2,0,169732,334961
ITC49,098,Lodi,53308,53356,2951,2665,48,2,1,112331,43548,53938,3863,13699,31,0,2,115081,227412
ITH59,099,Rimini,78015,75336,5349,4050,115,2,2,162869,68516,78177,7895,19310,27,4,0,173929,336798
ITI15,100,Prato,59812,58995,3284,3122,89,0,0,125302,51575,60843,4901,14412,38,1,1,131771,257073
ITF62,101,Crotone,40657,40442,1009,1921,0,0,0,84029,33350,40332,1274,9594,0,2,0,84552,168581
ITF64,102,Vibo Valentia,36048,37780,810,1952,2,2,0,76594,29581,38046,1032,9459,2,1,0,78121,154715
ITC14,103,Verbano-Cusio-Ossola,34814,35392,3274,2309,22,1,0,75812,28659,35989,4144,11690,23,0,3,80508,156320
ITC4D,108,Monza e della Brianza,199701,204090,11854,10461,194,0,2,426302,171352,207790,16330,48285,132,2,0,443891,870193
ITI35,109,Fermo,38437,41252,1899,2311,12,0,1,83912,31430,42081,2638,11658,18,0,0,87825,171737
ITF48,110,Barletta-Andria-Trani,84856,98480,2159,4638,23,0,0,190156,74187,99322,3093,18040,3,0,0,194645,384801
ITG2H,111,Sud Sardegna,81972,80226,4112,4467,15,1,0,170793,66519,79791,4485,22589,16,1,1,173402,344195
